tick,total_infected,total_recovered,total_dead,total_healthy,hot_region_infected,cold_region_infected,moderate_region_infected,airport_usage,port_usage,num_isolated_countries,num_affected_countries,most_affected_country,most_deaths_country,hot_region_transmission_rate,cold_region_transmission_rate,moderate_region_transmission_rate,cross_border_infections,within_country_infections
0,3,0,0,11529,0,0,3,0,0,0,2,Romania,,0,0,6.297229219143577E-4,0,3
1,7,0,0,11525,0,0,7,0,0,0,2,Romania,,0,0,0.0014693534844668346,0,7
2,13,0,0,11519,0,0,13,0,0,0,2,Romania,,0,0,0.00272879932829555,0,13
3,16,0,0,11516,0,0,16,0,0,0,2,Romania,,0,0,0.0033585222502099076,0,16
4,21,0,0,11511,0,0,21,0,0,0,2,Romania,,0,0,0.004408060453400504,0,21
5,22,0,0,11510,0,0,22,0,0,0,2,Romania,,0,0,0.004617968094038623,0,22
6,23,0,0,11509,0,0,23,0,0,0,2,Romania,,0,0,0.004827875734676742,0,23
7,27,0,0,11505,0,0,27,0,0,0,2,Romania,,0,0,0.005667506297229219,0,27
8,29,0,0,11503,0,0,29,0,0,0,2,Romania,,0,0,0.006087321578505458,0,29
9,30,0,0,11502,0,0,30,0,0,0,2,Romania,,0,0,0.006297229219143577,0,30
10,31,0,0,11501,0,0,31,0,0,0,2,Romania,,0,0,0.006507136859781696,0,31
11,32,0,0,11500,0,0,32,0,0,0,2,Romania,,0,0,0.006717044500419815,0,32
12,32,0,0,11500,0,0,32,0,0,0,2,Romania,,0,0,0.006717044500419815,0,32
13,35,0,0,11497,0,0,35,0,0,0,2,Romania,,0,0,0.0073467674223341725,0,35
14,36,0,0,11496,0,0,36,0,0,0,2,Romania,,0,0,0.007556675062972292,0,36
15,38,0,0,11494,0,0,38,0,0,0,3,Romania,,0,0,0.00797649034424853,0,38
16,41,0,0,11491,0,0,41,0,0,0,4,Romania,,0,0,0.008606213266162888,0,41
17,41,0,0,11491,0,0,41,0,0,0,4,Romania,,0,0,0.008606213266162888,0,41
18,44,0,0,11488,1,0,43,0,0,0,5,Romania,,1.539408866995074E-4,0,0.009026028547439127,0,44
19,46,0,0,11486,1,0,45,0,0,0,6,Romania,,1.539408866995074E-4,0,0.009445843828715366,0,46
20,50,0,0,11482,1,0,49,0,0,0,7,Romania,,1.539408866995074E-4,0,0.010285474391267842,0,50
21,52,0,0,11480,1,0,51,0,0,0,7,Romania,,1.539408866995074E-4,0,0.010705289672544081,0,52
22,54,1,0,11477,2,0,52,0,0,0,8,Romania,,3.078817733990148E-4,0,0.0109151973131822,0,54
23,56,3,0,11473,2,0,54,0,0,0,9,Romania,,3.078817733990148E-4,0,0.011335012594458438,0,56
24,57,5,0,11470,2,0,55,0,0,0,9,Romania,,3.078817733990148E-4,0,0.011544920235096557,0,57
25,61,5,0,11466,2,0,59,0,0,0,10,Romania,,3.078817733990148E-4,0,0.012384550797649035,0,61
26,63,6,0,11463,2,0,61,0,0,0,11,Romania,,3.078817733990148E-4,0,0.012804366078925274,0,63
27,63,8,0,11461,2,0,61,0,0,0,11,Romania,,3.078817733990148E-4,0,0.012804366078925274,0,63
28,67,10,0,11455,2,0,65,0,0,0,12,Romania,,3.078817733990148E-4,0,0.01364399664147775,0,67
29,66,13,0,11453,2,0,64,0,0,0,13,Romania,,3.078817733990148E-4,0,0.01343408900083963,0,66
30,75,15,0,11442,3,0,72,0,0,0,13,Romania,,4.6182266009852215E-4,0,0.015113350125944584,0,75
31,80,16,0,11436,3,0,77,0,0,0,14,Romania,,4.6182266009852215E-4,0,0.01616288832913518,0,80
32,87,16,0,11429,5,0,82,0,0,0,14,Ukraine,,7.69704433497537E-4,0,0.017212426532325777,0,87
33,90,16,0,11426,5,0,85,0,0,0,14,Romania,,7.69704433497537E-4,0,0.017842149454240133,0,90
34,92,19,0,11421,5,0,87,0,0,0,14,Ukraine,,7.69704433497537E-4,0,0.018261964735516372,0,92
35,98,21,0,11413,6,0,92,0,0,0,15,Ukraine,,9.236453201970443E-4,0,0.019311502938706968,0,98
36,103,22,0,11407,6,0,97,0,0,0,15,Ukraine,,9.236453201970443E-4,0,0.020361041141897566,0,103
37,106,24,0,11402,5,0,101,0,0,0,16,Ukraine,,7.69704433497537E-4,0,0.02120067170445004,0,106
38,109,27,0,11396,5,0,104,0,0,0,16,Ukraine,,7.69704433497537E-4,0,0.0218303946263644,0,109
39,114,28,0,11390,5,0,109,0,0,0,15,Turkey,,7.69704433497537E-4,0,0.022879932829554996,0,114
40,119,30,1,11382,5,0,114,0,0,0,15,Turkey,Bulgaria,7.69704433497537E-4,0,0.02392947103274559,0,119
41,119,31,1,11381,5,0,114,0,0,0,15,Turkey,Bulgaria,7.69704433497537E-4,0,0.02392947103274559,0,119
42,118,35,1,11378,6,0,112,0,0,0,15,Turkey,Bulgaria,9.236453201970443E-4,0,0.023509655751469353,0,118
43,119,38,1,11374,6,0,113,0,0,0,15,Turkey,Bulgaria,9.236453201970443E-4,0,0.023719563392107474,0,119
44,123,39,1,11369,6,0,117,0,0,0,16,Turkey,Bulgaria,9.236453201970443E-4,0,0.02455919395465995,0,123
45,124,41,3,11364,7,0,117,0,0,0,16,Turkey,Ukraine,0.0010775862068965517,0,0.02455919395465995,0,124
46,126,44,3,11359,7,0,119,0,0,0,16,Turkey,Ukraine,0.0010775862068965517,0,0.024979009235936187,0,126
47,137,45,3,11347,7,0,130,0,0,0,16,Turkey,Ukraine,0.0010775862068965517,0,0.0272879932829555,0,137
48,141,46,3,11342,7,0,134,0,0,0,17,Turkey,Ukraine,0.0010775862068965517,0,0.028127623845507977,0,141
49,149,49,4,11330,7,0,142,0,0,0,17,Turkey,Ukraine,0.0010775862068965517,0,0.02980688497061293,0,149
50,162,49,4,11317,7,0,155,0,0,0,17,Turkey,Ukraine,0.0010775862068965517,0,0.032535684298908484,0,162
51,170,51,4,11307,7,0,163,0,0,0,17,Turkey,Ukraine,0.0010775862068965517,0,0.03421494542401343,0,170
52,180,52,4,11296,7,0,173,0,0,0,18,Turkey,Ukraine,0.0010775862068965517,0,0.03631402183039462,0,180
53,200,56,5,11271,7,0,193,0,0,0,18,Turkey,Ukraine,0.0010775862068965517,0,0.04051217464315701,0,200
54,221,58,6,11247,7,0,214,0,0,0,19,Turkey,Ukraine,0.0010775862068965517,0,0.044920235096557515,0,221
55,230,59,6,11237,8,0,222,0,0,0,20,Turkey,Ukraine,0.0012315270935960591,0,0.04659949622166247,0,230
56,237,62,6,11227,8,0,229,0,0,0,19,Turkey,Ukraine,0.0012315270935960591,0,0.048068849706129305,0,237
57,238,68,6,11220,9,0,229,0,0,0,18,Turkey,Ukraine,0.0013854679802955665,0,0.048068849706129305,0,238
58,239,71,7,11215,9,0,230,0,0,0,18,Turkey,Ukraine,0.0013854679802955665,0,0.04827875734676742,0,239
59,240,76,7,11209,10,0,230,0,0,0,19,Turkey,Ukraine,0.001539408866995074,0,0.04827875734676742,0,240
60,248,82,7,11195,10,0,238,0,0,0,18,Turkey,Ukraine,0.001539408866995074,0,0.049958018471872374,0,248
61,254,86,7,11185,11,0,243,0,0,0,18,Turkey,Ukraine,0.0016933497536945814,0,0.05100755667506297,0,254
62,258,92,7,11175,11,0,247,0,0,0,18,Turkey,Ukraine,0.0016933497536945814,0,0.05184718723761545,0,258
63,275,94,7,11156,13,0,262,0,0,0,18,Turkey,Ukraine,0.0020012315270935962,0,0.05499580184718724,0,275
64,286,97,7,11142,14,0,272,0,0,0,18,Turkey,Ukraine,0.0021551724137931034,0,0.05709487825356843,0,286
65,296,105,7,11124,13,0,283,0,0,0,18,Turkey,Ukraine,0.0020012315270935962,0,0.059403862300587744,0,296
66,300,111,8,11113,11,0,289,0,0,0,18,Turkey,Ukraine,0.0016933497536945814,0,0.06066330814441646,0,300
67,310,117,8,11097,12,0,298,0,0,0,17,Turkey,Ukraine,0.0018472906403940886,0,0.06255247691015953,0,310
68,309,129,9,11085,12,0,297,0,0,0,17,Turkey,Ukraine,0.0018472906403940886,0,0.06234256926952141,0,309
69,329,134,9,11060,11,0,318,0,0,0,17,Germany,Ukraine,0.0016933497536945814,0,0.06675062972292191,0,329
70,340,141,10,11041,12,0,328,0,0,0,17,Germany,Ukraine,0.0018472906403940886,0,0.0688497061293031,0,340
71,356,145,12,11019,13,0,343,0,0,0,17,Germany,Ukraine,0.0020012315270935962,0,0.0719983207388749,0,356
72,368,153,13,10998,13,0,355,0,0,0,17,Germany,Ukraine,0.0020012315270935962,0,0.07451721242653232,0,368
73,380,165,13,10974,14,0,366,0,0,0,18,Germany,Ukraine,0.0021551724137931034,0,0.07682619647355164,0,380
74,390,176,13,10953,14,0,376,0,0,0,20,Germany,Ukraine,0.0021551724137931034,0,0.07892527287993283,0,390
75,395,187,13,10937,15,0,380,0,0,0,21,Germany,Ukraine,0.002309113300492611,0,0.07976490344248531,0,395
76,401,193,13,10925,17,0,384,0,0,0,22,Germany,Ukraine,0.0026169950738916255,0,0.08060453400503778,0,401
77,417,201,14,10900,17,0,400,0,0,0,22,Germany,Turkey,0.0026169950738916255,0,0.08396305625524769,0,417
78,425,211,15,10881,18,0,407,0,0,0,22,Germany,Turkey,0.002770935960591133,0,0.08543240973971453,0,425
79,438,217,15,10862,19,0,419,0,0,0,21,Germany,Ukraine,0.0029248768472906403,0,0.08795130142737195,0,438
80,452,227,17,10836,20,0,432,0,0,0,20,Germany,Turkey,0.003078817733990148,0,0.0906801007556675,0,452
81,462,230,19,10821,21,0,441,0,0,0,20,Germany,Turkey,0.003232758620689655,0,0.09256926952141058,0,462
82,463,239,22,10808,25,0,438,0,0,0,20,Germany,Turkey,0.003848522167487685,0,0.09193954659949623,0,463
83,464,246,24,10798,30,0,434,0,0,0,22,Germany,Turkey,0.004618226600985222,0,0.09109991603694374,0,464
84,470,257,25,10780,37,0,433,0,0,0,22,Germany,Turkey,0.005695812807881773,0,0.09089000839630562,0,470
85,471,266,26,10769,41,0,430,0,0,0,22,Germany,Turkey,0.006311576354679803,0,0.09026028547439127,0,471
86,466,275,28,10763,44,0,422,0,0,0,21,Germany,Turkey,0.0067733990147783255,0,0.08858102434928632,0,466
87,478,284,28,10742,53,0,425,0,0,0,23,Germany,Turkey,0.008158866995073892,0,0.08921074727120067,0,478
88,469,299,29,10735,56,0,413,0,0,0,23,Germany,Turkey,0.008620689655172414,0,0.08669185558354324,0,469
89,477,308,29,10718,64,0,413,0,0,0,23,Germany,Turkey,0.009852216748768473,0,0.08669185558354324,0,477
90,476,320,31,10705,70,0,406,0,0,0,23,Germany,Turkey,0.010775862068965518,0,0.0852225020990764,0,476
91,471,333,31,10697,69,0,402,0,0,0,23,Germany,Turkey,0.010621921182266009,0,0.08438287153652393,0,471
92,469,347,31,10685,73,0,396,0,0,0,23,Germany,Turkey,0.01123768472906404,0,0.08312342569269521,0,469
93,469,358,31,10674,75,0,394,0,0,0,24,Germany,Turkey,0.011545566502463054,0,0.08270361041141898,0,469
94,471,364,31,10666,78,0,393,0,0,0,24,Germany,Turkey,0.012007389162561576,0,0.08249370277078086,0,471
95,472,374,33,10653,82,0,390,0,0,0,24,Germany,Turkey,0.012623152709359606,0,0.0818639798488665,0,472
96,470,386,35,10641,86,0,384,0,0,0,25,Germany,Turkey,0.013238916256157635,0,0.08060453400503778,0,470
97,460,405,36,10631,87,0,373,0,0,0,25,Germany,Turkey,0.013392857142857142,0,0.07829554995801848,0,460
98,444,424,36,10628,87,0,357,0,0,0,25,Italy,Turkey,0.013392857142857142,0,0.07493702770780857,0,444
99,424,454,37,10617,88,0,336,0,0,0,26,Italy,Turkey,0.013546798029556651,0,0.07052896725440806,0,424
100,416,467,38,10611,88,0,328,0,0,0,26,Italy,Turkey,0.013546798029556651,0,0.0688497061293031,0,416
101,407,481,41,10603,84,0,323,0,0,0,26,Italy,Turkey,0.01293103448275862,0,0.06780016792611251,0,407
102,393,501,42,10596,84,0,309,0,0,0,25,Italy,Turkey,0.01293103448275862,0,0.06486146095717885,0,393
103,382,517,45,10588,82,0,300,0,0,0,25,Italy,Turkey,0.012623152709359606,0,0.06297229219143577,0,382
104,378,531,46,10577,84,0,294,0,0,0,24,Italy,Turkey,0.01293103448275862,0,0.061712846347607056,0,378
105,384,537,48,10563,88,0,296,0,0,0,25,Italy,Turkey,0.013546798029556651,0,0.06213266162888329,0,384
106,376,555,50,10551,87,0,289,0,0,0,24,France,Turkey,0.013392857142857142,0,0.06066330814441646,0,376
107,367,568,53,10544,87,0,280,0,0,0,25,France,Turkey,0.013392857142857142,0,0.05877413937867338,0,367
108,359,582,54,10537,87,0,272,0,0,0,23,France,Turkey,0.013392857142857142,0,0.05709487825356843,0,359
109,349,598,54,10531,84,0,265,0,0,0,23,France,Turkey,0.01293103448275862,0,0.0556255247691016,0,349
110,345,605,57,10525,86,0,259,0,0,0,25,France,Turkey,0.013238916256157635,0,0.05436607892527288,0,345
111,340,617,58,10517,86,0,254,0,0,0,25,France,Turkey,0.013238916256157635,0,0.053316540722082285,0,340
112,327,638,61,10506,87,0,240,0,0,0,24,France,Turkey,0.013392857142857142,0,0.05037783375314862,0,327
113,326,645,61,10500,87,0,239,0,0,0,24,France,Turkey,0.013392857142857142,0,0.050167926112510496,0,326
114,316,664,62,10490,83,0,233,0,0,0,24,France,Turkey,0.012777093596059113,0,0.04890848026868178,0,316
115,307,674,64,10487,81,0,226,0,0,0,24,France,Turkey,0.012469211822660099,0,0.04743912678421495,0,307
116,299,687,67,10479,78,0,221,0,0,0,24,France,Turkey,0.012007389162561576,0,0.04638958858102435,0,299
117,291,698,69,10474,76,0,215,0,0,0,24,France,Turkey,0.011699507389162561,0,0.045130142737195636,0,291
118,288,711,69,10464,71,0,217,0,0,0,24,France,Turkey,0.010929802955665025,0,0.04554995801847187,0,288
119,279,723,70,10460,68,0,211,0,0,0,25,France,Turkey,0.010467980295566502,0,0.04429051217464316,0,279
120,277,731,71,10453,66,0,211,0,0,0,25,France,Turkey,0.010160098522167487,0,0.04429051217464316,0,277
121,272,742,72,10446,61,0,211,0,0,0,25,France,Turkey,0.009390394088669951,0,0.04429051217464316,0,272
122,267,750,75,10440,61,0,206,0,0,0,23,France,Turkey,0.009390394088669951,0,0.04324097397145256,0,267
123,266,760,75,10431,62,0,204,0,0,0,22,France,Turkey,0.009544334975369459,0,0.042821158690176324,0,266
124,253,774,75,10430,61,0,192,0,0,0,21,United Kingdom,Turkey,0.009390394088669951,0,0.04030226700251889,0,253
125,244,789,76,10423,58,0,186,0,0,0,19,United Kingdom,Turkey,0.008928571428571428,0,0.03904282115869018,0,244
126,240,796,79,10417,58,0,182,0,0,0,19,United Kingdom,Turkey,0.008928571428571428,0,0.0382031905961377,0,240
127,242,804,79,10407,57,0,185,0,0,0,18,United Kingdom,Turkey,0.008774630541871921,0,0.038832913518052056,0,242
128,239,812,80,10401,57,0,182,0,0,0,18,United Kingdom,Turkey,0.008774630541871921,0,0.0382031905961377,0,239
129,242,820,80,10390,57,0,185,0,0,0,18,United Kingdom,Turkey,0.008774630541871921,0,0.038832913518052056,0,242
130,236,828,85,10383,57,0,179,0,0,0,19,United Kingdom,Turkey,0.008774630541871921,0,0.03757346767422334,0,236
131,235,840,85,10372,54,0,181,0,0,0,18,United Kingdom,Turkey,0.0083128078817734,0,0.03799328295549958,0,235
132,240,848,85,10359,54,0,186,0,0,0,18,United Kingdom,Turkey,0.0083128078817734,0,0.03904282115869018,0,240
133,244,856,85,10347,56,0,188,0,0,0,19,United Kingdom,Turkey,0.008620689655172414,0,0.03946263643996641,0,244
134,251,859,86,10336,58,0,193,0,0,0,18,United Kingdom,Turkey,0.008928571428571428,0,0.04051217464315701,0,251
135,249,867,87,10329,61,0,188,0,0,0,18,United Kingdom,Turkey,0.009390394088669951,0,0.03946263643996641,0,249
136,247,872,90,10323,63,0,184,0,0,0,18,United Kingdom,Turkey,0.009698275862068966,0,0.038623005877413935,0,247
137,243,882,92,10315,67,0,176,0,0,0,17,United Kingdom,Turkey,0.010314039408866995,0,0.036943744752308987,0,243
138,243,888,93,10308,68,0,175,0,0,0,17,United Kingdom,Turkey,0.010467980295566502,0,0.036733837111670865,0,243
139,251,893,93,10295,75,0,176,0,0,0,17,United Kingdom,Turkey,0.011545566502463054,0,0.036943744752308987,0,251
140,254,898,93,10287,80,0,174,0,0,0,17,United Kingdom,Turkey,0.012315270935960592,0,0.036523929471032744,0,254
141,253,907,93,10279,85,0,168,0,0,0,17,United Kingdom,Turkey,0.013084975369458128,0,0.03526448362720403,0,253
142,248,915,93,10276,85,0,163,0,0,0,17,United Kingdom,Turkey,0.013084975369458128,0,0.03421494542401343,0,248
143,251,919,93,10269,91,0,160,0,0,0,17,United Kingdom,Turkey,0.014008620689655173,0,0.033585222502099076,0,251
144,248,927,93,10264,94,0,154,0,0,0,17,United Kingdom,Turkey,0.014470443349753694,0,0.03232577665827036,0,248
145,248,930,93,10261,97,0,151,0,0,0,17,United Kingdom,Turkey,0.014932266009852218,0,0.031696053736356006,0,248
146,243,940,94,10255,98,0,145,0,0,0,17,United Kingdom,Turkey,0.015086206896551725,0,0.03043660789252729,0,243
147,243,944,95,10250,100,0,143,0,0,0,18,United Kingdom,Turkey,0.01539408866995074,0,0.03001679261125105,0,243
148,235,958,96,10243,100,0,135,0,0,0,18,United Kingdom,Turkey,0.01539408866995074,0,0.028337531486146095,0,235
149,237,965,97,10233,106,0,131,0,0,0,18,United Kingdom,Turkey,0.016317733990147784,0,0.02749790092359362,0,237
150,233,971,98,10230,104,0,129,0,0,0,17,United Kingdom,Turkey,0.01600985221674877,0,0.02707808564231738,0,233
151,234,978,98,10222,110,0,124,0,0,0,18,United Kingdom,Turkey,0.016933497536945813,0,0.026028547439126783,0,234
152,238,981,99,10214,114,0,124,0,0,0,19,United Kingdom,Turkey,0.017549261083743842,0,0.026028547439126783,0,238
153,234,994,100,10204,118,0,116,0,0,0,18,United Kingdom,Turkey,0.01816502463054187,0,0.02434928631402183,0,234
154,238,996,102,10196,124,0,114,0,0,0,17,Spain,Turkey,0.019088669950738917,0,0.02392947103274559,0,238
155,238,1009,103,10182,131,0,107,0,0,0,16,Egypt,Turkey,0.020166256157635468,0,0.022460117548278757,0,238
156,245,1013,103,10171,136,0,109,0,0,0,16,Egypt,Turkey,0.020935960591133004,0,0.022879932829554996,0,245
157,247,1021,103,10161,142,0,105,0,0,0,16,Egypt,Turkey,0.02185960591133005,0,0.02204030226700252,0,247
158,248,1033,104,10147,146,0,102,0,0,0,15,Egypt,Turkey,0.02247536945812808,0,0.021410579345088162,0,248
159,245,1045,104,10138,148,0,97,0,0,0,14,Egypt,Turkey,0.022783251231527094,0,0.020361041141897566,0,245
160,243,1053,104,10132,149,0,94,0,0,0,14,Egypt,Turkey,0.0229371921182266,0,0.019731318219983206,0,243
161,245,1057,106,10124,152,0,93,0,0,0,14,Egypt,Turkey,0.023399014778325122,0,0.01952141057934509,0,245
162,240,1067,107,10118,150,0,90,0,0,0,14,Egypt,Turkey,0.023091133004926108,0,0.018891687657430732,0,240
163,238,1077,109,10108,151,0,87,0,0,0,14,Egypt,Turkey,0.023245073891625615,0,0.018261964735516372,0,238
164,241,1081,110,10100,155,0,86,0,0,0,14,Egypt,Turkey,0.023860837438423644,0,0.018052057094878254,0,241
165,248,1086,111,10087,161,0,87,0,0,0,13,Egypt,Turkey,0.02478448275862069,0,0.018261964735516372,0,248
166,246,1093,113,10080,163,0,83,0,0,0,13,Egypt,Turkey,0.025092364532019705,0,0.017422334172963894,0,246
167,248,1098,114,10072,169,0,79,0,0,0,13,Egypt,Turkey,0.026016009852216748,0,0.01658270361041142,0,248
168,248,1102,117,10065,171,0,77,0,0,0,13,Egypt,Turkey,0.026323891625615763,0,0.01616288832913518,0,248
169,242,1110,119,10061,168,0,74,0,0,0,13,Egypt,Turkey,0.02586206896551724,0,0.015533165407220823,0,242
170,235,1118,120,10059,164,0,71,0,0,0,12,Egypt,Turkey,0.025246305418719212,0,0.014903442485306465,0,235
171,232,1122,121,10057,161,0,71,0,0,0,11,Egypt,Turkey,0.02478448275862069,0,0.014903442485306465,0,232
172,233,1125,122,10052,163,0,70,0,0,0,11,Egypt,Turkey,0.025092364532019705,0,0.014693534844668345,0,233
173,234,1134,122,10042,163,0,71,0,0,0,11,Egypt,Turkey,0.025092364532019705,0,0.014903442485306465,0,234
174,239,1137,123,10033,168,0,71,0,0,0,11,Egypt,Turkey,0.02586206896551724,0,0.014903442485306465,0,239
175,238,1145,124,10025,168,0,70,0,0,0,12,Egypt,Turkey,0.02586206896551724,0,0.014693534844668345,0,238
176,241,1151,124,10016,168,0,73,0,0,0,12,Egypt,Turkey,0.02586206896551724,0,0.015323257766582703,0,241
177,234,1161,125,10012,162,0,72,0,0,0,12,Egypt,Turkey,0.024938423645320198,0,0.015113350125944584,0,234
178,232,1168,125,10007,160,0,72,0,0,0,13,Egypt,Turkey,0.024630541871921183,0,0.015113350125944584,0,232
179,226,1175,126,10005,156,0,70,0,0,0,13,Egypt,Turkey,0.02401477832512315,0,0.014693534844668345,0,226
180,214,1186,127,10005,148,0,66,0,0,0,12,Egypt,Turkey,0.022783251231527094,0,0.013853904282115869,0,214
181,207,1193,129,10003,144,0,63,0,0,0,12,Egypt,Turkey,0.022167487684729065,0,0.01322418136020151,0,207
182,203,1202,131,9996,139,0,64,0,0,0,12,Egypt,Turkey,0.02139778325123153,0,0.01343408900083963,0,203
183,199,1208,131,9994,135,0,64,0,0,0,12,Egypt,Turkey,0.020782019704433496,0,0.01343408900083963,0,199
184,192,1215,131,9994,132,0,60,0,0,0,12,Egypt,Turkey,0.020320197044334975,0,0.012594458438287154,0,192
185,185,1225,131,9991,125,0,60,0,0,0,12,Egypt,Turkey,0.019242610837438424,0,0.012594458438287154,0,185
186,177,1232,133,9990,117,0,60,0,0,0,12,Egypt,Turkey,0.018011083743842363,0,0.012594458438287154,0,177
187,175,1239,133,9985,114,0,61,0,0,0,12,Egypt,Turkey,0.017549261083743842,0,0.012804366078925274,0,175
188,166,1250,133,9983,106,0,60,0,0,0,11,Egypt,Turkey,0.016317733990147784,0,0.012594458438287154,0,166
189,157,1259,134,9982,98,0,59,0,0,0,11,Egypt,Turkey,0.015086206896551725,0,0.012384550797649035,0,157
190,154,1262,134,9982,95,0,59,0,0,0,11,Egypt,Turkey,0.014624384236453201,0,0.012384550797649035,0,154
191,151,1267,134,9980,92,0,59,0,0,0,11,Egypt,Turkey,0.01416256157635468,0,0.012384550797649035,0,151
192,143,1275,134,9980,85,0,58,0,0,0,11,Egypt,Turkey,0.013084975369458128,0,0.012174643157010915,0,143
193,133,1284,136,9979,80,0,53,0,0,0,11,Egypt,Turkey,0.012315270935960592,0,0.01112510495382032,0,133
194,130,1287,138,9977,78,0,52,0,0,0,11,Egypt,Turkey,0.012007389162561576,0,0.0109151973131822,0,130
195,126,1293,139,9974,76,0,50,0,0,0,11,Egypt,Turkey,0.011699507389162561,0,0.010495382031905962,0,126
196,119,1300,140,9973,69,0,50,0,0,0,11,Egypt,Turkey,0.010621921182266009,0,0.010495382031905962,0,119
197,114,1308,140,9970,62,0,52,0,0,0,10,Egypt,Turkey,0.009544334975369459,0,0.0109151973131822,0,114
198,108,1316,140,9968,56,0,52,0,0,0,10,Egypt,Turkey,0.008620689655172414,0,0.0109151973131822,0,108
199,102,1321,141,9968,52,0,50,0,0,0,10,Egypt,Turkey,0.008004926108374385,0,0.010495382031905962,0,102
200,93,1328,143,9968,44,0,49,0,0,0,10,Egypt,Turkey,0.0067733990147783255,0,0.010285474391267842,0,93
201,87,1333,145,9967,41,0,46,0,0,0,10,Egypt,Turkey,0.006311576354679803,0,0.009655751469353484,0,87
202,80,1341,145,9966,34,0,46,0,0,0,10,Iran,Turkey,0.005233990147783251,0,0.009655751469353484,0,80
203,78,1345,146,9963,34,0,44,0,0,0,10,Iran,Turkey,0.005233990147783251,0,0.009235936188077247,0,78
204,74,1348,148,9962,31,0,43,0,0,0,10,Iran,Iran,0.004772167487684729,0,0.009026028547439127,0,74
205,67,1354,149,9962,29,0,38,0,0,0,10,Iran,Iran,0.004464285714285714,0,0.00797649034424853,0,67
206,61,1360,149,9962,26,0,35,0,0,0,10,Iran,Iran,0.0040024630541871924,0,0.0073467674223341725,0,61
207,61,1360,150,9961,26,0,35,0,0,0,10,Iran,Iran,0.0040024630541871924,0,0.0073467674223341725,0,61
208,60,1363,150,9959,24,0,36,0,0,0,10,Iran,Iran,0.003694581280788177,0,0.007556675062972292,0,60
209,57,1367,150,9958,23,0,34,0,0,0,9,Iran,Iran,0.00354064039408867,0,0.007136859781696054,0,57
210,54,1369,151,9958,21,0,33,0,0,0,9,Iran,Iran,0.003232758620689655,0,0.0069269521410579345,0,54
211,54,1371,151,9956,19,0,35,0,0,0,8,Iran,Iran,0.0029248768472906403,0,0.0073467674223341725,0,54
212,50,1374,152,9956,17,0,33,0,0,0,8,Iran,Iran,0.0026169950738916255,0,0.0069269521410579345,0,50
213,49,1376,152,9955,17,0,32,0,0,0,8,Iran,Iran,0.0026169950738916255,0,0.006717044500419815,0,49
214,45,1380,152,9955,15,0,30,0,0,0,8,Iran,Iran,0.002309113300492611,0,0.006297229219143577,0,45
215,41,1385,152,9954,14,0,27,0,0,0,8,Iran,Iran,0.0021551724137931034,0,0.005667506297229219,0,41
216,42,1386,152,9952,14,0,28,0,0,0,8,Iran,Iran,0.0021551724137931034,0,0.005877413937867338,0,42
217,41,1387,152,9952,14,0,27,0,0,0,8,Iran,Iran,0.0021551724137931034,0,0.005667506297229219,0,41
218,41,1389,152,9950,15,0,26,0,0,0,8,Iran,Iran,0.002309113300492611,0,0.0054575986565911,0,41
219,40,1390,153,9949,15,0,25,0,0,0,8,Iran,Iran,0.002309113300492611,0,0.005247691015952981,0,40
220,37,1393,153,9949,14,0,23,0,0,0,8,Iran,Iran,0.0021551724137931034,0,0.004827875734676742,0,37
221,36,1394,154,9948,14,0,22,0,0,0,8,Iran,Iran,0.0021551724137931034,0,0.004617968094038623,0,36
222,34,1396,154,9948,14,0,20,0,0,0,8,Iran,Iran,0.0021551724137931034,0,0.0041981528127623844,0,34
223,33,1397,154,9948,13,0,20,0,0,0,8,Iran,Iran,0.0020012315270935962,0,0.0041981528127623844,0,33
224,32,1399,154,9947,12,0,20,0,0,0,7,Iran,Iran,0.0018472906403940886,0,0.0041981528127623844,0,32
225,33,1399,154,9946,13,0,20,0,0,0,7,Iran,Iran,0.0020012315270935962,0,0.0041981528127623844,0,33
226,32,1401,154,9945,12,0,20,0,0,0,7,Iran,Iran,0.0018472906403940886,0,0.0041981528127623844,0,32
227,31,1403,154,9944,12,0,19,0,0,0,7,Iran,Iran,0.0018472906403940886,0,0.003988245172124265,0,31
228,32,1403,154,9943,13,0,19,0,0,0,7,Iran,Iran,0.0020012315270935962,0,0.003988245172124265,0,32
229,29,1406,154,9943,13,0,16,0,0,0,7,Iran,Iran,0.0020012315270935962,0,0.0033585222502099076,0,29
230,27,1409,154,9942,14,0,13,0,0,0,7,Iran,Iran,0.0021551724137931034,0,0.00272879932829555,0,27
231,28,1410,154,9940,16,0,12,0,0,0,7,Iran,Iran,0.0024630541871921183,0,0.0025188916876574307,0,28
232,32,1410,154,9936,20,0,12,0,0,0,7,Pakistan,Iran,0.003078817733990148,0,0.0025188916876574307,0,32
233,36,1410,154,9932,24,0,12,0,0,0,7,Pakistan,Iran,0.003694581280788177,0,0.0025188916876574307,0,36
234,36,1410,155,9931,25,0,11,0,0,0,7,Pakistan,Iran,0.003848522167487685,0,0.0023089840470193117,0,36
235,39,1411,155,9927,29,0,10,0,0,0,7,Pakistan,Iran,0.004464285714285714,0,0.0020990764063811922,0,39
236,38,1413,155,9926,29,0,9,0,0,0,6,Pakistan,Iran,0.004464285714285714,0,0.001889168765743073,0,38
237,41,1415,155,9921,32,0,9,0,0,0,6,Pakistan,Iran,0.0049261083743842365,0,0.001889168765743073,0,41
238,49,1418,155,9910,42,0,7,0,0,0,6,Pakistan,Iran,0.00646551724137931,0,0.0014693534844668346,0,49
239,54,1419,156,9903,48,0,6,0,0,0,6,Pakistan,Iran,0.007389162561576354,0,0.0012594458438287153,0,54
240,58,1422,156,9896,52,0,6,0,0,0,5,Pakistan,Iran,0.008004926108374385,0,0.0012594458438287153,0,58
241,66,1423,156,9887,61,0,5,0,0,0,5,Pakistan,Iran,0.009390394088669951,0,0.0010495382031905961,0,66
242,75,1423,156,9878,70,0,5,0,0,0,5,Pakistan,Iran,0.010775862068965518,0,0.0010495382031905961,0,75
243,90,1423,156,9863,85,0,5,0,0,0,5,Pakistan,Iran,0.013084975369458128,0,0.0010495382031905961,0,90
244,101,1423,156,9852,96,0,5,0,0,0,5,Pakistan,Iran,0.014778325123152709,0,0.0010495382031905961,0,101
245,121,1424,156,9831,117,0,4,0,0,0,5,Pakistan,Iran,0.018011083743842363,0,8.396305625524769E-4,0,121
246,137,1424,156,9815,133,0,4,0,0,0,5,Pakistan,Iran,0.020474137931034482,0,8.396305625524769E-4,0,137
247,149,1424,157,9802,146,0,3,0,0,0,4,Pakistan,Iran,0.02247536945812808,0,6.297229219143577E-4,0,149
248,161,1424,157,9790,157,0,4,0,0,0,4,Pakistan,Iran,0.024168719211822662,0,8.396305625524769E-4,0,161
249,177,1424,157,9774,173,0,4,0,0,0,6,Pakistan,Iran,0.026631773399014777,0,8.396305625524769E-4,0,177
250,186,1425,157,9764,183,0,3,0,0,0,6,Pakistan,Iran,0.028171182266009853,0,6.297229219143577E-4,0,186
251,201,1427,157,9747,198,0,3,0,0,0,6,Pakistan,Iran,0.030480295566502464,0,6.297229219143577E-4,0,201
252,223,1428,157,9724,220,0,3,0,0,0,6,Pakistan,Iran,0.033866995073891626,0,6.297229219143577E-4,0,223
253,243,1429,157,9703,240,0,3,0,0,0,6,Pakistan,Iran,0.03694581280788178,0,6.297229219143577E-4,0,243
254,280,1429,157,9666,276,0,4,0,0,0,7,Pakistan,Iran,0.042487684729064036,0,8.396305625524769E-4,0,280
255,323,1429,158,9622,319,0,4,0,0,0,7,Pakistan,Iran,0.049107142857142856,0,8.396305625524769E-4,0,323
256,356,1435,158,9583,352,0,4,0,0,0,7,Pakistan,Iran,0.054187192118226604,0,8.396305625524769E-4,0,356
257,406,1437,158,9531,401,0,5,0,0,0,7,Pakistan,Iran,0.06173029556650246,0,0.0010495382031905961,0,406
258,446,1441,158,9487,440,0,6,0,0,0,7,Pakistan,Iran,0.06773399014778325,0,0.0012594458438287153,0,446
259,495,1443,158,9436,488,0,7,0,0,0,7,Pakistan,Iran,0.07512315270935961,0,0.0014693534844668346,0,495
260,544,1444,158,9386,537,0,7,0,0,0,7,Pakistan,Iran,0.08266625615763547,0,0.0014693534844668346,0,544
261,595,1445,159,9333,588,0,7,0,0,0,7,Pakistan,Iran,0.09051724137931035,0,0.0014693534844668346,0,595
262,640,1454,160,9278,632,0,8,0,0,0,7,India,Iran,0.09729064039408868,0,0.0016792611251049538,0,640
263,688,1460,162,9222,681,0,7,0,0,0,7,India,Iran,0.10483374384236453,0,0.0014693534844668346,0,688
264,737,1462,163,9170,731,0,6,0,0,0,7,India,Iran,0.1125307881773399,0,0.0012594458438287153,0,737
265,801,1465,163,9103,795,0,6,0,0,0,7,India,Iran,0.12238300492610837,0,0.0012594458438287153,0,801
266,871,1470,163,9028,863,0,8,0,0,0,9,India,Iran,0.13285098522167488,0,0.0016792611251049538,0,871
267,929,1475,163,8965,920,0,9,0,0,0,9,India,Iran,0.1416256157635468,0,0.001889168765743073,0,929
268,988,1481,164,8899,974,0,14,0,0,0,9,India,Iran,0.1499384236453202,0,0.002938706968933669,0,988
269,1043,1489,164,8836,1020,0,23,0,0,0,9,India,Iran,0.15701970443349753,0,0.004827875734676742,0,1043
270,1096,1498,164,8774,1058,0,38,0,0,0,9,India,Iran,0.16286945812807882,0,0.00797649034424853,0,1096
271,1142,1504,164,8722,1085,0,57,0,0,0,10,India,Iran,0.16702586206896552,0,0.011964735516372796,0,1142
272,1198,1511,164,8659,1119,0,79,0,0,0,11,India,Iran,0.17225985221674878,0,0.01658270361041142,0,1198
273,1264,1519,166,8583,1167,0,97,0,0,0,11,India,Iran,0.17964901477832512,0,0.020361041141897566,0,1264
274,1312,1536,168,8516,1197,0,115,0,0,0,11,India,Iran,0.18426724137931033,0,0.02413937867338371,0,1312
275,1366,1549,171,8446,1233,0,133,0,0,0,11,India,Iran,0.1898091133004926,0,0.027917716204869856,0,1366
276,1417,1568,172,8375,1267,0,150,0,0,0,11,India,Iran,0.19504310344827586,0,0.031486146095717885,0,1417
277,1471,1585,172,8304,1309,0,162,0,0,0,11,India,Iran,0.20150862068965517,0,0.03400503778337532,0,1471
278,1506,1615,179,8232,1330,0,176,0,0,0,12,India,Iran,0.20474137931034483,0,0.036943744752308987,0,1506
279,1564,1633,179,8156,1374,0,190,0,0,0,12,India,Iran,0.21151477832512317,0,0.039882451721242655,0,1564
280,1616,1658,183,8075,1408,0,208,0,0,0,12,India,Iran,0.21674876847290642,0,0.0436607892527288,0,1616
281,1678,1687,185,7982,1455,0,223,0,0,0,13,India,Iran,0.22398399014778325,0,0.046809403862300585,0,1678
282,1734,1707,189,7902,1495,0,239,0,0,0,13,India,Iran,0.23014162561576354,0,0.050167926112510496,0,1734
283,1772,1743,190,7827,1522,0,250,0,0,0,13,India,Pakistan,0.23429802955665024,0,0.05247691015952981,0,1772
284,1816,1774,194,7748,1558,0,258,0,0,0,13,India,Pakistan,0.23983990147783252,0,0.05415617128463476,0,1816
285,1850,1813,198,7671,1584,0,266,0,0,0,13,India,Pakistan,0.2438423645320197,0,0.05583543240973971,0,1850
286,1875,1852,202,7603,1598,0,277,0,0,0,13,India,Pakistan,0.2459975369458128,0,0.058144416456759024,0,1875
287,1890,1890,207,7545,1602,0,288,0,0,0,13,India,India,0.24661330049261085,0,0.060453400503778336,0,1890
288,1935,1925,211,7461,1635,0,300,0,0,0,13,India,India,0.25169334975369456,0,0.06297229219143577,0,1935
289,1969,1965,214,7384,1656,0,313,0,0,0,12,India,India,0.25492610837438423,0,0.06570109151973132,0,1969
290,1989,2007,215,7321,1664,0,325,0,0,0,12,India,India,0.2561576354679803,0,0.06821998320738874,0,1989
291,2005,2051,217,7259,1669,0,336,0,0,0,13,India,India,0.2569273399014778,0,0.07052896725440806,0,2005
292,2012,2099,220,7201,1664,0,348,0,0,0,14,India,India,0.2561576354679803,0,0.07304785894206549,0,2012
293,2044,2140,224,7124,1679,0,365,0,0,0,14,India,India,0.2584667487684729,0,0.07661628883291352,0,2044
294,2093,2186,232,7021,1712,0,381,0,0,0,14,India,India,0.26354679802955666,0,0.07997481108312343,0,2093
295,2131,2240,243,6918,1745,0,386,0,0,0,15,India,India,0.2686268472906404,0,0.08102434928631402,0,2131
296,2195,2284,247,6806,1795,0,400,0,0,0,15,India,India,0.27632389162561577,0,0.08396305625524769,0,2195
297,2220,2325,257,6730,1798,0,422,0,0,0,16,India,India,0.2767857142857143,0,0.08858102434928632,0,2220
298,2206,2392,260,6674,1769,0,437,0,0,0,17,India,India,0.27232142857142855,0,0.0917296389588581,0,2206
299,2187,2449,264,6632,1736,0,451,0,0,0,17,India,India,0.2672413793103448,0,0.09466834592779177,0,2187
300,2172,2508,270,6582,1707,0,465,0,0,0,17,India,India,0.2627770935960591,0,0.09760705289672544,0,2172
301,2151,2572,273,6536,1679,0,472,0,0,0,18,India,India,0.2584667487684729,0,0.09907640638119228,0,2151
302,2115,2636,281,6500,1635,0,480,0,0,0,18,India,India,0.25169334975369456,0,0.10075566750629723,0,2115
303,2097,2688,285,6462,1600,0,497,0,0,0,18,India,India,0.24630541871921183,0,0.10432409739714525,0,2097
304,2061,2749,293,6429,1557,0,504,0,0,0,18,India,India,0.239685960591133,0,0.10579345088161209,0,2061
305,2019,2808,302,6403,1511,0,508,0,0,0,18,India,India,0.23260467980295566,0,0.10663308144416457,0,2019
306,1986,2863,303,6380,1474,0,512,0,0,0,18,India,India,0.2269088669950739,0,0.10747271200671704,0,1986
307,1933,2935,311,6353,1421,0,512,0,0,0,18,India,India,0.21875,0,0.10747271200671704,0,1933
308,1890,2989,318,6335,1378,0,512,0,0,0,18,India,India,0.21213054187192118,0,0.10747271200671704,0,1890
309,1842,3056,323,6311,1326,0,516,0,0,0,18,India,India,0.2041256157635468,0,0.10831234256926953,0,1842
310,1788,3114,335,6295,1273,0,515,0,0,0,18,India,India,0.1959667487684729,0,0.1081024349286314,0,1788
311,1723,3183,341,6285,1217,0,506,0,0,0,18,India,India,0.1873460591133005,0,0.10621326616288833,0,1723
312,1668,3241,349,6274,1168,0,500,0,0,0,18,India,India,0.17980295566502463,0,0.10495382031905962,0,1668
313,1595,3318,357,6262,1102,0,493,0,0,0,19,India,India,0.16964285714285715,0,0.10348446683459278,0,1595
314,1545,3376,362,6249,1056,0,489,0,0,0,19,India,India,0.1625615763546798,0,0.1026448362720403,0,1545
